########################################
#......................................#
#.####################################.#
#.#..................................#.#
#.#.################################.#.#
#.#.#..............................#.#.#
#.#.#.############################.#.#.#
#.#.#.#..........F...............#.#.#.#
#.#.#.#.########################.#.#.#.#
#.#.#.#.#......................#.#.#.#.#
#.#.#.#.#.####################.#.#.#.#.#
#.#.#.#.#.#........P.........#.#.#.#.#.#
#.#.#.#.#.####################.#.#.#.#.#
#.#.#.#.#......................#.#.#.#.#
#.#.#.#.########################.#.#.#.#
#.#.#.#..........................#.#.#.#
#.#.################################.#.#
#.#..................................#.#
#.####################################.#
#......................................#